

S texture1.xpm
W texture1.xpm
E     texture1.xpm
N texture1.xpm


C  142  ,    1   , 144
F 255   ,  140  , 12

1111111111111111111111111111111111
1111000000000110000001110001011111
101100000111000000000000001111111
10001000000000000000000001111111
1111111110110000011100000000000011
10000011111100000111010111111111101
1111011100001110111000000100011111
1111011111111101110101001000111111
1100001100011011000000100001111111
1000001100000100110000001000111111
1111011111111101011011110101011111
100000001100000110101N010001111111
1100000000010101111101111010111111001
1111111111111111111111111111111111





