
W texture1.xpm

N   texture.xpm

E     texture1.xpm

S texture1.xpm

C  142  ,   34   , 144
F 255   ,  140  , 12


111111111111111111111111111111111111
1111111111111101111111111111111110001
1000000000110000000000001111111111111
10110000011100000000000011111111110001
10010000000000000000000011111111111111
111111111011000001110000000000001111111111
1000000001100000N11111111111111100000001
111111111111111111111111111111111111111111
1111111111111111111111111111111111111
110000001101010111000000100011111
100000000000000011000000100011111
100000000000000011010100100011111
11000001010101011111011110101111111111111111
1111011101110101101111010001111100000011111
1111111111111111111111111111111111111
