
WE     texture1.xpm

NO   texture.xpm

EA    texture1.xpm
SO   texture1.xpm

C  142  ,   98  , 100     
F 255   ,  140  , 0     

111111111111111111111111111111111111111111        
111111111011000001110000000000001111111111     1
100000000110000011111111111111100000001     111
111111111111111111N11111111111111111111111
11111111111111111111111101111111111
11111111111111111111111111111
1111
111111111111111111111111111111111111111111         1
1000000000000000110010010001111101
11000001010101011111011110101111111111111111
111101110111010110111101001111     10000001111
111111111111111111111111111111111111111111





