
WE    t e x t u r e.xpm                 

NO   texture1.xpm      

EA    texture1.xpm     
SO   texture1.xpm        

C  142  ,   98  , 100     
F 255   ,  140  , 0     


11111111111 
111            
 111  1    
     1S1    
 1    1111
101             
1111111111 
          