WE    t e x t u r e.xpm                 

NO   texture1.xpm      

EA    texture1.xpm     
SO   texture1.xpm        

C  142  ,   98  , 100     
F 255   ,  140  , 0     
            11111111111                        
            11111111111                        
            11100000111
            11111111111
111111111111111111111111111111111111111111        
111111111011000001110000000000001111111111     1
100011S1000110000011111111111111100000001              1
11111111111111111010111111111111111111111111
11111111111111111111111101111111111
11111111111111111111111111111
1111
111111111111111111111111111111111111111111         1
1000000000000000110010010001111101
11000001010101011111011110101111111111111111
111101110111010110111101001111     10000001111
111111111111111111111111111111111111111111





