
WE              texture1.xpm

NO   texture.xpm


EA     texture1.xpm
SO   texture1.xpm

C  142  ,   98  , 1
F 255   ,  140  , 12

111111111111111111111111111111111111111111        
111111111011000001110000000000001111111111     1
100000000110000011111111111111100000001     111
111111111111111111111111111111111111111111
11111111111111111111111111111111111
11000000110101011100000100011111
1000000000000000110000001000111111         1
1000000000000000110010010001111101
11000001010101011111011110101111111111111111
11110111011101011011110100011111000000N1111
11111111111111111111111111111111111111111





